1111111111
10000000E1
10000C0001
1P000C00C1
1C00000001
1C00000021
1111111111
