1111111111
10000000E1
1000000001
1P000000C1
1C00000001
1C00000021
1111111111
