1111111111
10000000E1
1P00000001
10000000C1
1C00000001
1C00000021
1111111111
